G G W G G G G G R G
G G W G G G G G R G
G G W G R R R R R G
G G W G R M M M R G
G G W G R M M M R G
G G W G R R R R R G
G G W G G G G G R G
G G W W W W W W R G
M M M M M M M W R G
M M M M M M M W R G